NO ./tex/window42_SD.xpm42
SO ./tex/hud_coul_SD.xpm42
WE ./tex/door42.xpm42
EA ./tex/dungeon42.xpm42

F 121,212,121
C 212,121,212

        1111111111111111111111111
        1000000000110000000000001
        1011000001110000000000001
        1001000000000000000000001
111111111011000001110000000000001
100000000011000001110111111111111
11110111111111011100000010001
11110111111111011101010010001
1100000000000011100000010001
10000000N00000001100000010001
10000000100000001101010010001
1100000000000001111101111000111
100000011100001 101111010001
11111111 1111111 111111111111