NO ./textures/blanc42.xpm42
SO ./textures/blue42.xpm42
WE ./textures/green42.xpm42
EA ./textures/wood42_legion.xpm42

C 34,208,111
F 163,103,90

        1111111111111111111111111
        1000000000000000000000001
        1000000000001000000000001
        1000001000000000010000001
111111111011000000000000000000001
100000000011000000000000000011111
11110000000000011100000010001
11110000000000011101010010001
11001000000101011100001000001
11000100000000001100000010001
100000S0000000001101010010001
1100000111010101111101111000111
11110111 1110101 101111010001
11111111 1111111 111111111111